1,.,.,+,.,.,1
.,2,+,.,+,2,.
3,+,3,.,3,+,3
.,8,.,8,.,8,.
5,.,10,+,10,.,5
+,6,+,6,+,6,+
7,+,14,+,14,+,7
+,8,+,8,+,8,+
18,+,18,+,18,+,18
20,20,20,+,20,20,20
+,+,+,+,+,+,+
+,+,+,+,+,+,+
+,+,+,+,+,+,+
+,+,+,.,+,+,+
+,+,.,500,.,+,+
+,+,+,.,+,+,+
+,+,+,+,+,+,+
+,+,+,+,+,+,+
.,.,.,.,.,.,.
.,.,.,.,.,.,.
.,.,.,.,.,.,.
.,.,.,.,.,.,.
.,.,.,.,.,.,.
.,.,.,.,.,.,.
.,.,.,.,.,.,.