.,.,1,.,1,.,+
2,+,2,.,2,.,.
.,3,.,.,3,.,3
4,.,.,.,.,4,.
5,.,10,+,+,5,.
5,+,10,.,.,5,.
5,+,10,.,.,5,.
5,+,10,.,.,5,.
.,.,.,.,.,.,.
.,.,.,.,.,.,.
.,.,.,.,.,.,.
.,.,.,.,.,.,.
.,.,.,.,.,.,.
.,.,.,.,.,.,.
.,.,.,.,.,.,.
.,.,.,.,.,.,.
.,.,.,.,.,.,.
.,.,.,.,.,.,.
.,.,.,.,.,.,.
.,.,.,.,.,.,.