1,1,+,+,+,1,1
+,2,+,8,+,2,+
+,2,+,6,+,2,+
+,3,+,8,+,3,+
+,3,+,+,+,3,+
+,4,+,8,+,4,+
+,4,+,6,+,4,+
+,5,+,8,+,5,+
+,10,+,+,+,10,+
+,50,+,+,+,50,+
+,100,+,300,+,100,+
150,+,+,+,+,+,150
+,+,+,500,+,+,+
150,+,+,+,+,+,150
+,+,+,+,+,+,+
+,+,+,+,+,+,+
+,+,+,+,+,+,+
.,.,.,.,.,.,.
.,.,.,.,.,.,.
.,.,.,.,.,.,.
.,.,.,.,.,.,.
.,.,.,.,.,.,.
.,.,.,.,.,.,.
