2,3,+,2,1,1,1
+,2,+,1,+,+,+
+,2,+,1,+,10,+
+,2,+,1,+,+,+
+,2,+,2,1,1,1
2,3,+,+,+,+,+
+,+,+,4,3,3,3
+,+,+,3,+,+,+
+,+,+,3,+,50,+
+,+,+,3,+,+,+
+,+,+,4,3,3,3
+,+,+,+,+,+,+
+,20,10,10,10,20,+
+,10,+,+,+,10,+
+,10,+,400,+,10,+
+,+,+,+,+,+,+
200,200,200,200,200,200,200
.,.,.,.,.,.,.
.,.,.,.,.,.,.
.,.,.,.,.,.,.
.,.,.,.,.,.,.
.,.,.,.,.,.,.
.,.,.,.,.,.,.
